##### ####
#   ###  #
#       @#
##       ##
#         #
#   #    $#
######## .#
       ####
