##############
#         #  #
####      #  #
#      @$.   #
#####        #
#      ###   #
#        #   #
#     ####   #
# #          #
##############
